##########
#.    @  #
#  . $   #
#    $   #
#        #
##########

