    ####
    #  # 
    #$ #
  ### $###
  # $  $ #
### # ## #   ######
#   # ## #####  ..# 
# $  $          ..# 
##### ### #@##  ..#
    #     #########
    #######


####
#  #
#  #
####