##########
#.     $ #
# $     .#
# @     $#
#       .#
##########

