XXXXXXXXXXXX
XX   X    @X
XX    $ $$ X
XX..$XX$  XX
X .. X  XXXX
X  . $. XXXX
XXXXXXXXXXXX