XXXXXXXXXXXX
XX   X     X
XX   X ..  X
XX$$$ X..XXX
X $    @XXXX
X   X   XXXX
XXXXXXXXXXXX